11111111111111111
1E00C000011111111
10011P00C00011111
10000000001010CE1
110C0000000000011
110100C0010000011
11C0001000100C001
1100000000C000101
100C1C000000100C1
10011100001010001
1000C100C01010C01
10000000000000001
1C000000110010001
111C00011C0000101
1C0101000000000C1
1E0000011E10C0011
11111111111111111