111111111111
1E00C0001111
10011P001111
100000000CE1
110C00000011
1000C1000C01
100000000001
1C0000000001
111000000101
111C010000C1
1E0000010011
111111111111